------------------------------------------------------------------------------------------------------------------------------------------------
 | P   | 0:0:1        | 0:1:1        | 0:2:1        | 0:3:1        | 0:4:1        | 0:5:1        | 0:6:1        | 0:7:1        | 0:8:1        | 
 | P   | 0:0:0 ITX567 | 0:1:0 ASX123 | 0:2:0        | 0:3:0        | 0:4:0        | 0:5:0        | 0:6:0        | 0:7:0        | 0:8:0        | 
------------------------------------------------------------------------------------------------------------------------------------------------
 | PD  | 1:0:1        | 1:1:1        | 1:2:1        | 1:3:1        | 1:4:1        | 1:5:1        | 1:6:1        | 1:7:1        | 1:8:1        | 
 | PD  | 1:0:0 ITB431 | 1:1:0        | 1:2:0        | 1:3:0        | 1:4:0        | 1:5:0        | 1:6:0        | 1:7:0        | 1:8:0        | 
------------------------------------------------------------------------------------------------------------------------------------------------
 | PD  | 2:0:1        | 2:1:1        | 2:2:1        | 2:3:1        | 2:4:1 ETB246 | 2:5:1        | 2:6:1        | 2:7:1        | 2:8:1        | 
 | PD  | 2:0:0        | 2:1:0        | 2:2:0        | 2:3:0        | 2:4:0        | 2:5:0        | 2:6:0        | 2:7:0        | 2:8:0        | 
------------------------------------------------------------------------------------------------------------------------------------------------
 | PDH | 3:0:1        | 3:1:1        | 3:2:1        | 3:3:1        | 3:4:1        | 3:5:1        | 3:6:1        | 3:7:1        | 3:8:1        | 
 | PDH | 3:0:0        | 3:1:0        | 3:2:0        | 3:3:0        | 3:4:0        | 3:5:0        | 3:6:0        | 3:7:0        | 3:8:0        | 
------------------------------------------------------------------------------------------------------------------------------------------------
 | PDH | 4:0:1        | 4:1:1        | 4:2:1        | 4:3:1        | 4:4:1        | 4:5:1        | 4:6:1        | 4:7:1        | 4:8:1        | 
 | PDH | 4:0:0        | 4:1:0        | 4:2:0        | 4:3:0        | 4:4:0        | 4:5:0        | 4:6:0        | 4:7:0        | 4:8:0        | 
------------------------------------------------------------------------------------------------------------------------------------------------
 | PDH | 5:0:1        | 5:1:1        | 5:2:1        | 5:3:1 GEA321 | 5:4:1        | 5:5:1        | 5:6:1        | 5:7:1        | 5:8:1        | 
 | PDH | 5:0:0        | 5:1:0        | 5:2:0        | 5:3:0        | 5:4:0        | 5:5:0        | 5:6:0        | 5:7:0        | 5:8:0        | 
------------------------------------------------------------------------------------------------------------------------------------------------
